"","age","gender","deaths.x","deaths.y","deaths"
"1","0-9","Male",38,74,36
"2","10-19","Male",19,37,18
"3","20-29","Male",67,130,63
"4","30-39","Male",191,371,180
"5","40-49","Male",392,760,368
"6","50-59","Male",421,815,394
"7","60+","Male",908,1760,852
"8","0-9","Female",29,56,27
"9","10-19","Female",0,0,0
"10","20-29","Female",10,19,9
"11","30-39","Female",96,185,89
"12","40-49","Female",124,241,117
"13","50-59","Female",172,334,162
"14","60+","Female",258,500,242
